000000000000000000000000000000000000000000000000000000000000000
000000000000000000000000000000000000000000000000000000000000000
000000000000000000000000000000000000000000000000000000000000000
000000000000000000000000000000000000000000000000000000000000000
000000000000000000000000000000000000000000000000000000000000000
000000000000000000000000000000000000000000000000000000000000000
000000000000000000000000000000000000000000000000000000000000000
000000000000000000000000000000000000000000000000000000000000000
000000000000000000000000001111110000000000000000000000000000000
000000000000000000000000111111111110000000000000000000000000000
000000000000000000000011111111111111100000000000000000000000000
000000000000000000001111111111111111111111000000000000000000000
000000000000000000111111111111111111111110000000000000000000000
000000000000000011111111111111111111111111110000000000000000000
000000000000001111111111111111111111111111100000000000000000000
000000000000011111111111100110011111111111100000000000000000000
000000000000111111111111000000001111111111111000000000000000000
000000000002222222222222200000013333333333333333000000000000000
000000000022222222222222220000333333333333333333300000000000000
000000000022222222222222222002333333333333333333333000000000000
000000000002222222222222222222233333333333333333333330000000000
000000000000022222222222222233333333333333333333333330000000000
000000000000022222222222222222333333333333333333333300000000000
000000000000222222222222222222333333333333333333333333000000000
000000000002222222222222222220003333333333333333333300000000000
000000000022222222222222220000000033333333333333333300000000000
000000000022222222222222200000000000333333333333333000000000000
000000000002222222222220000000000000033333333333333300000000000
000000000000222222222000000000000000000033333333330000000000000
000000000000000222200000000000000000000000000000000000000000000
000000000000000000000000000000000000000000000000000000000000000
000000000000000000000000000000000000000000000000000000000000000
000000000000000000000000000000000000000000000000000000000000000
000000000000000000000000000000000000000000000000000000000000000
000000000000000000000000000000000000000000000000000000000000000
000000000000000000000000000000000000000000000000000000000000000
000000000000000000000000000000000000000000000000000000000000000
000000000000000000000000000000000000000000000000000000000000000
000000000000000000000000000000000000000000000000000000000000000
000000000000000000000000000000000000000000000000000000000000000